I,i,1,one,One
II,ii,2,two,Two
III,iii,3,three,Three
IV,iv,4,four,Four
V,v,5,five,Five

Aardappelmeel=>Patato flour
Aardappeloproer=>Aardappeloproer
Aardgaswinning=>Natural gas extraction
Aardolie-industrie=>Petroleum industry
Aardoliewinning=>Petroleum extraction
Abonneewerving=>Subscriber canvassing
Aboriginals=>Aboriginals
Abortus=>Abortion
Administratiekantoren=>Administrative office
Advertentie=>Advertisement
Affiche=>Poster
AIDS=>AIDS
Akkerbouw=>Agriculture
Akkerbouwers=>Farmers
Album=>Album
Albumplaatje=>Picture card for album
Alfabetisering=>Literacy projects
Algemeen kiesrecht=>Universal suffrage
Alleenstaanden=>Single people
Ambtenarij=>Officialdom
Anarchisme=>Anarchism
Anarcho-feminisme=>Anarcho-feminism
Anarcho-syndicalisme=>Anarcho-syndicalism
Annexatie=>Annexation
Anticommunisme=>Anti-communism
Antiek=>Antiques
Antifascisme=>Anti-fascism
Anti-imperialisme=>Anti-imperialism
Antikapitalisme=>Anti-capitalism
Antiklerikalisme=>Anti-clericalism
Antillianen=>Antillians
Antiparlementarisme=>Anti-parliamentarism
Antisemitisme=>Anti-Semitism
Antisocialisme=>Anti-socialism
Arabieren=>Arabs
Arbeid=>Labour
Arbeiders=>Workers
Arbeidersbeweging=>Labour movement
Arbeiderszelfbestuur=>Workers' control
Arbeidsbemiddeling=>Employment finding
Arbeidsdienst=>Labour service
Arbeidsduur=>Working hours
Arbeidsmarkt=>Labour-market
Arbeidsmoraal=>Labour ethics
Arbeidsomstandigheden=>Working conditions
Arbeidsongeschiktheid=>Disablement
Arbeidsongeschiktheidsverzekeringen=>Disablement insurance
Arbeidsovereenkomsten=>Labour agreements
Arbeidsrecht=>Labour law
Arbeidsvergunning=>Work permit
Arbeidsverhoudingen=>Labour relations
Arbeidsvoorwaarden=>Employment conditions
Architecten=>Architects
Archives format=>Archives format
Armenie¦êrs=>Armenians
Armenzorg=>Poor relief
Armoede=>Poverty
Artsen=>Physicians
Atheisme=>Atheism
Audio-apparatuur=>Audio equipment
Auteursrecht=>Copyright
Auto=>Motorcar
Autohandel=>Car trade
Autoindustrie=>Car industry
Automatisering=>Automation
Automonteurs=>Car mechanics
Autoreparatiebedrijven=>Car garages
Autorijles=>Driving lessons
Autosloperijen=>Car demolition yards
Autoslopers=>Car demolishers
Baggerbedrijven=>Dredging companies
Bakkerijen=>Bakeries
Bakkers=>Bakers
Banden=>Tires
Bankwezen=>Banking
Batterijen=>Batteries
Beddengoed=>Bedding
Bedoei¦êenen=>Bedouin
Bedrijfsbezettingen=>Sit-in strikes
Bedrijfsleven=>Trade and industry
Bedrijfsorganisatie=>Industrial organization
Bedrijfssluitingen=>Closing-down of companies
Bedrijfsveiligheid=>Occupational safety
Bedrijfsvormen=>Company types
Beeldend kunstenaars=>Visual artists
Beeldende kunst=>Visual arts
Begrafenisondernemingen=>Funeral business
Begrafenisritueel=>Funeral ritual
Behang=>Wall paper
Belastingen=>Taxes
Belletrie=>Literature
Benzinestations=>Petrol stations
Beroepen=>Occupations
Beroepsonderwijs=>Vocational education
Besloten vennootschap=>Company
Bestrijdingsmiddelen=>Pesticides
Beurtschippers=>Bargemen
Beurtvaart=>Regular barge service
Bevolkingspolitiek=>Population policy
Bevrijding=>Liberation
Bewakingsdiensten=>Security services
Bezetting=>Occupation
Bezettingen=>Sit-down strikes
Bibliotheekwezen=>Libraries
Bier=>Beer
Bierbrouwerijen=>Beer breweries
Binnenschippers=>River bargemen
Binnenvaart=>Inland navigation
Biografica=>Biographica
Biologen=>Biologists
Biologische evolutie=>Biological evolution
Bioscoopreclame=>Cinema advertising
Bloemen=>Flowers
Bodemverontreiniging=>Soil pollution
Boeken=>Books
Boekenlegger=>Bookmarker
Boekhandel=>Booksellers
Boeren=>Farmers
Borduursters=>Embroiderers
Borstelmakerijen=>Brushmaking
Borstelmakers=>Brush makers
Bosbouw=>Forestry
Bosbouwarbeiders=>Foresters
Bouwmaterialenindustrie=>Building materials industry
Bouwnijverheid=>Building industry
Bouwvakarbeiders=>Building workers
Brandstof=>Fuel
Brandstofgebrek=>Fuel shortage
Brandweer=>Fire brigade
Brandweerlieden=>Firemen
Breiers=>Knitters
Brief=>Letter
Brochure=>Leaflet
Brood=>Bread
Brugwachters=>Bridge-keepers
Buitenboordmotoren=>Outboard motors
Buitenlands beleid=>Foreign policy
Buitenlandse betrekkingen=>Foreign relations
Buitenlandse contacten=>Foreign contacts
Buitenlandse hulp=>Foreign aid
Buitenlandse interventie=>Foreign intervention
Buitenlandse werknemers=>Migrant workers
Bureaucratie=>Bureaucracy
Burgeroorlogen=>Civil wars
Burgerrechten=>Civil rights
Button=>Button
Buurthuizen=>Community centres
Cacao=>Cocoa
Cadeauartikelen=>Gift articles
Cafe¦üs=>Pubs
CAO's=>Collective labour agreement
Carnaval=>Carnival
CD=>CD
CD (foto CD)=>CD (photo CD)
CD-ROM=>CD-ROM
Censuur=>Censorship
Chauffeurs=>Drivers
Chemici=>Chemists
Chemigrafen=>Chemigraphers
Chemische industrie=>Chemical industry
Chemische wapens=>Chemical weapons
Chinezen=>Chinese
Cholera=>Cholera
Christelijke partijen=>Christian parties
Christen-democratie=>Christian democracy
Christendom=>Christianity
Christenen=>Christians
Circulaire=>Circular
Civiele verdediging=>Civil defence
Collaboratie=>Collaboration
Collectivisatie=>Collectivization
Commune van Parijs=>Paris Commune
Communisme=>Communism
Computerprint=>Computer print
Concentratiekampen=>Concentration camps
Confessionele vakbeweging=>Denominational trade union movement
Congresverslag=>Conference report
Conservatisme=>Conservatism
Consumentenbelangen=>Consumer issues
Consumptiemaatschappij=>Consumer society
Contractarbeid=>Bonded labour
Coo¦êperaties=>Co-operatives
Corporatisme=>Corporatism
Corruptie=>Corruption
Criminaliteit=>Criminality
Cultuur=>Culture
Cultuurbeleid=>Culture policy
Dakdekkers=>Roofers
Dakdekkersbedrijven=>Roofing companies
Dans=>Dance
Decentralisatie=>Decentralization
Deelraadsverkiezingen=>Borough council elections
Defensiebeleid=>Defence policy
Dekolonisatie=>Decolonization
Delfstoffenwinning=>Mineral mining
Democratie=>Democracy
Democratisering=>Democratization
Deportatie=>Deportation
Derdewereldbeweging=>Third World movement
Desintegratie=>Desintegration
Destalinisatie=>De-Stalinization
Detailhandel=>Retail trade
Detectivebureaus=>Detective agencies
Devaluatie=>Devaluation
Dia=>Slide
Diamantbewerkers=>Diamond workers
Diamantindustrie=>Diamond industry
Dictaturen=>Dictatorships
Dienstplicht=>Conscription
Dienstweigering=>Conscientious objection
Dierenbescherming=>Animal protection
Dierenparken=>Zoological gardens
Diervoeding=>Animal feed
Digitale foto=>Digital photo
Diplomaten=>Diplomats
Discriminatie=>Discrimination
Diskette=>Diskette
Display=>Display
Distributie=>Distribution
Doodstraf=>Capital punishment
Douane=>Customs
Drankbestrijding=>Temperance movement
Drankenindustrie=>Beverage industry
Drankverbod=>Prohibition
Drugs=>Drugs
Drukkerijen=>Printing business
Drukkers=>Printers
Dubbelportret=>Double portrait
Duitsers=>Germans
DVD=>DVD
Dwangarbeid=>Forced labour
Economie=>Economy
Economisch beleid=>Economic policy
Economische betrekkingen=>Economic relations
Economische crises=>Economic crises
Economische orde=>Economic order
Edelsmeden=>Gold- and silversmiths
Effectenmakelaars=>Stockbrokers
Electrotechnische industrie=>Electrotechnical industry
Emancipatie=>Emancipation
Emancipatie van negers=>Negro emancipation
Emigratie=>Emigration
Energie=>Energy
Energiebedrijven=>Energy companies
Energieprijzen=>Energy prices
Energievoorziening=>Energy supply
Enque¦éte=>Inquiry
Enveloppe=>Envelope
Eskimo's=>Eskimo's
Esperanto=>Esperanto
Etnische groepen=>Ethnic groups
Etnische minderheden=>Ethnic minorities
Europese verkiezingen=>European elections
Euthanasie=>Euthanasia
Ex-libris=>Ex libris
Fabrieksarbeiders=>Factory workers
Fabrieksgebouwen=>Factory buildings
Fascisme=>Fascism
Fastfood=>Fastfood
Feminisme=>Feminism
Fiets=>Bicycle
Fietsenmakers=>Bicycle repairers
Filmapparatuur=>Film equipment
Filmindustrie=>Film industry
Filmstrook=>Still
Filosofie=>Philosophy
Financie¦ên=>Finance
Financieel beleid=>Financial policy
Foto=>Photo
Foto-apparatuur=>Photographic equipment
Fotografen=>Photographers
Fotografie=>Photography
Fotokopie=>Photocopy
Fotozaken=>Photograhic shops
Franquisme=>Franquismo
Franse revolutie=>French Revolution
Frisdrank=>Soft drinks
Fruit=>Fruit
Fundamentalisme=>Fundamentalism
Garnalenpellers=>Shrimp-peelers
Gasmaskers=>Gas masks
Gebak=>Pastry
Geboortenregeling=>Birth control
Gebouwen=>Buildings
Gecollectiviseerde bedrijven=>Collective enterprises
Geestelijke gezondheidszorg=>Mental health care
Geestelijkheid=>Clergy
Gehandicapten=>Disabled
Gei¦ênterneerden=>Internees
Geldwezen=>Monetary matters
Geluidsband=>Audio tape
Geluidscassette=>Audio cassette
Geluidshinder=>Noise pollution
Gemeenteraadsleden=>Municipal councillors
Geneesmiddelen=>Medicines
Geneesmiddelenindustrie=>Pharmaceutical industry
Genetische technologie=>Genetic engineering
Gereedschap=>Tools
Gereedschapmakers=>Tool makers
Gereformeerde kerk=>Reformed church
Geschiedenis=>History
Geslachtsziekte=>Venereal disease
Gevaarlijke stoffen=>Dangerous goods
Gevangenen=>Prisoners
Gevangeniswezen=>Prisons
Geweldloosheid=>Nonviolence
Gezin=>Family
Gezinshulp=>Home help
Gezondheid=>Health
Gezondheidszorg=>Public health
Gijzelaars=>Hostages
Glasblazers=>Glassblowers
Glazenwasserijen=>Windowcleaning business
Glazenwassers=>Windowcleaners
Glazuurwerksters=>Ceramics industry workers
Globalisme=>Globalism
Goudzoekers=>Golddiggers
Graan=>Corn
Graanmalerijen=>Corn mills
Grafdelvers=>Gravediggers
Grafische industrie=>Graphic industry
Grammofoonplaat=>Gramophone record
Grenskwesties=>Border disputes
Grieken=>Greeks
Groente=>Vegetables
Groepsportret=>Group portrait
Grondbezit=>Landed ownership
Grondbouw=>Civil engineering
Grondwerkers=>Navvies
Grondwetten=>Constitutions
Handboek=>Reference works
Handel=>Trade
Handelsbeleid=>Trade policy
Havenarbeiders=>Dock-workers
Havens=>Docks
Herdenkingen=>Commemorations
Hereniging=>Reunification
Herstelbetalingen=>War reparations
Hindoei¦êsme=>Hinduism
Hoedenmakers=>Hatters
Hoger onderwijs=>Higher education
Hoger personeel=>High-ranked staff
Homobeweging=>Gay and lesbian movement
Homo-emancipatie=>Gay emancipation
Homoseksualiteit=>Homosexuality
Hongaren=>Hungarians
Hongersnood=>Famine
Horeca=>Hotel and catering industry
Horecapersoneel=>Hotel workers
Horlogemakers=>Watch makers
Houtbewerkers=>Woodworkers
Houtindustrie=>Wood-working industry
Hoveniers=>Gardeners
Huisarbeid=>Work at home
Huisdieren=>Pets
Huishoudelijke apparaten=>Household utensils
Huishoudelijke arbeid=>Household work
Huishoudelijke artikelen=>Household articles
Huispersoneel=>Domestic servants
Huisvesting=>Housing
Humanisme=>Humanism
Huurprijzen=>Rent
Huwelijk=>Marriage
Identiteitsbewijs=>Identity card
Ideologie=>Ideology
Ieren=>Irish
Immigranten=>Immigrants
Imperialisme=>Imperialism
Indianen=>Indians
Individualisering=>Individualization
Indonesie¦êrs=>Indonesians
Industrialisatie=>Industrialization
Industrie=>Industry
Informatie- en communicatietechnologie=>Information and communication technology
Informele economie=>Hidden economy
Infrastructuur=>Infrastructure
Inlichtingendiensten=>Intelligence agencies
Inpolderingen=>Land reclamation
Installatiebedrijven=>Installation companies
Instrumentmakers=>Instrument-makers
Integratie=>Integration
Intensieve veeteelt=>Factory farming
Islam=>Islam
Italianen=>Italians
Jacht=>Hunting
Jeugd=>Youth
Jeugdbewegingen=>Youth movements
Jeugdcentra=>Youth centres
Jeugdcultuur=>Youth life style
Jeugdherbergen=>Youth hostels
Jeugdloon=>Juvenile wage
Jeugdwerk=>Youth work
Jeugdwerkloosheid=>Youth unemployment
Joden=>Jews
Jodenvervolging=>Persecution of the Jews
Joegoslaven=>Yugoslavs
Jongerenhuisvesting=>Youth housing
Jordaanoproer=>Jordaan Revolt
Journalisten=>Journalists
Jubilea=>Anniversaries
Junta=>Junta
Justitie=>Judicature
Juweliers=>Juwelers
Kaapverdianen=>Cape Verdians
Kaarders=>Carders
Kaarsenmakerijen=>Candle-making
Kaarsenmakers=>Candle-makers
Kalender=>Calendar
Kampeerterreinen=>Camping grounds
Kamperen=>Camp
Kanker=>Cancer
Kansspelen=>Games of chance
Kantoorbenodigdheden=>Office supplies
Kantoormeubilair=>Office equipment
Kantoorpersoneel=>Office clerks
Kantwerkers=>Lace makers
Kapitalisme=>Capitalism
Kappers=>Hairdressers
Kappersbedrijven=>Hairdresser's salons
Kapp-Putsch=>Kapp-Putsch
Karikatuur=>Caricature
Kartelvorming=>Cartel formation
Katoen=>Cotton
Keramische industrie=>Ceramics industry
Kerken=>Churches
Kernafval=>Nuclear waste
Kernenergie=>Nuclear energy
Kernproeven=>Nuclear tests
Kernwapens=>Nuclear weapons
Kiesrecht=>Suffrage
Kiesstelsel=>Electoral system
Kinderarbeid=>Child labour
Kinderbijslag=>Family allowance
Kinderen=>Children
Kindermishandeling=>Child molestation
Kinderopvang=>Nurseries
Kinderzorg=>Child care
Klassenstrijd=>Class struggle
Kleding=>Clothes
Kledingindustrie=>Clothing industry
Kleermakers=>Tailors
Klein drukwerk=>Small printed matter
Kleuteronderwijs=>Nursery education
Klompenmakers=>Clog makers
Knipsel=>Cutting
Koerden=>Kurds
Koffie=>Coffee
Koffielezers=>Food workers
Kolen=>Coal
Kolenboeren=>Coalmen
Koloniaal beleid=>Colonial policy
Kopieerbedrijven=>Copying companies
Koude oorlog=>Cold War
Kraakbeweging=>Squatters movement
Krantenbezorgers=>Newspaper-boys
Krijgsgevangenen=>Prisoners of war
Krijgshandelingen=>Acts of war
Krijgsmacht=>Armed forces
Krimtataren=>Crimean Tatars
Kruideniers=>Grocers
Kunst=>Art
Kunstenaars=>Artists
Kunstmest=>Fertilizer
Kunststofverwerkende industrie=>Synthetic materials processing
Kunstvezelindustrie=>Synthetic fibres industry
Kurk=>Cork
Kurkwarenindustrie=>Corkware industry
Laboranten=>Laboratory technicians
Lager onderwijs=>Primary education
Landarbeiders=>Agricultural workers
Landbouw=>Agriculture
Landbouwbeleid=>Agricultural policy
Landbouwcoo¦êperaties=>Agricultural co-operatives
Landelijke verkiezingen=>General elections
Landhervormingen=>Land reform
Landkaart=>Map
Landmacht=>Land-forces
Ledenwerving=>Membership recruitment
Leefgemeenschappen=>Communities
Leerindustrie=>Leather industry
Leerplicht=>Compulsory education
Leraren=>Secondary school teachers
Lesbianisme=>Lesbianism
Lesmateriaal=>Teaching materials
Levensomstandigheden=>Living conditions
Levensstandaard=>Standard of living
Liberalisme=>Liberalism
Lichaamsverzorgingsproducten=>Body care products
Lidmaatschapskaart=>Membership card
Liedteksten=>Song texts
Lijkverbranding=>Cremation
Linkse politieke samenwerking=>Left-wing political co-operation
Links-radikalisme=>Left-wing radicalism
Lokale omroep=>Local broadcasting companies
Lokale politiek=>Local politics
Lokale verkiezingen=>Local elections
Lokaties=>Locations
Lompensorteerders=>Rag-sorters
Loodgieters=>Plumbers
Loodsen=>Pilots
Looierijen=>Tanneries
Loon=>Wages
Luchtmacht=>Air-force
Luchtvaart=>Aviation
Luchtvaartpersoneel=>Aviation staff
Luchtverontreiniging=>Air pollution
Lucifers=>Matches
Maatschappelijk werk=>Social work
Machine-industrie=>Machine building industry
Makelaars=>Estate agents
Malaria=>Malaria
Mandenmakers=>Basket-makers
Mannen=>Men
Mannenemancipatie=>Men's liberation
Manuscript=>Manuscript
Maoi¦êsme=>Maoism
Maquette=>Scale-model
Margarine=>Margarine
Marine=>Navy
Markten=>Market places
Marktkooplieden=>Market stallholders
Marokkanen=>Moroccans
Marskramers=>Pedlars
Marxisme=>Marxism
Mattenvlechters=>Matplaiters
Mechanisatie=>Mechanization
Medezeggenschap=>Workers' participation
Media=>Media
Mediabeleid=>Media policy
Medische hulpmiddelen=>Medical aids
Meditatie=>Meditation
Mei 1968=>May 1968
Meiden=>Girls
Mensenrechten=>Human rights
Metaalbewerkers=>Metal workers
Metaalindustrie=>Metal industry
Metro=>Underground railway
Metselaars=>Bricklayers
Meubelmakerijen=>Furniture-making
Meubelmakers=>Cabinet makers
Middelbaar onderwijs=>Secondary education
Middenstand=>Tradespeople
Migranten=>Migrants
Migrantencultuur=>Migrant culture
Migratie=>Migration
Mijnbouw=>Mining
Mijnwerkers=>Miners
Milieubeleid=>Environmental policy
Milieubescherming=>Environment protection
Milieubeweging=>Environmentalism
Milieuvriendelijke bedrijven=>Environmentally sound businesses
Milieuvriendelijke produkten=>Environmentally sound products
Militaire dictaturen=>Military dictatorships
Militairen=>Military men
Militarisme=>Militarism
Minderheden=>Minorities
Minderhedenbeleid=>Minorities policy
Minimumloon=>Minimum wages
Mobilisatie=>Mobilization
Mode=>Fashion
Moederschap=>Motherhood
Moederschapszorg=>Maternity care
Molenaars=>Millers
Molens=>Mills
Molukkers=>Moluccans
Monarchie=>Monarchy
Monetair beleid=>Monetary policy
Montage=>Montage
Moslims=>Muslims
Multinationale ondernemingen=>Multinationals
Munt=>Coin
Muurkrant=>Newspaper poster
Muurschildering=>Mural painting
Muziek=>Music
Muziekinstrumenten=>Musical instruments
Naaisters=>Seamstresses
Naamloze vennootschap=>Limited liability company
Naamsbekendheid=>Renown
Nachtarbeid=>Night work
Narodniki=>Narodniki
Nationaal-socialisme=>National socialism
Nationalisatie=>Nationalization
Nationalisme=>Nationalism
Naturisme=>Naturism
Natuurbehoud=>Nature conservation
Natuurgeneeswijze=>Naturopathy
Natuurrampen=>Natural disasters
Natuurvriendenwerk=>Nature study
Negatief=>Negative
Neonazisme=>Neo-Nazism
Nettenboeters=>Net-menders
Nihilisten=>Nihilists
Noodtoestand=>State of emergency
Normen en waarden=>Standards and values
Oliecrises=>Oil crises
Oliemaatschappijen=>Petrol companies
Omroep=>Broadcasting
Onafhankelijkheid=>Independence
Onafhankelijkheidsstrijd=>Struggle for independence
Onderlinge verzekeringen=>Mutual insurance
Onderwijs=>Education
Onderwijsbeleid=>Education policy
Onderwijzers=>Primary school teachers
Ontslagen=>Dismissals
Ontwerp=>Design
Ontwikkelingsproblematiek=>Development
Oorkonde=>Charter
Oorlog en vrede=>War and peace
Oorlogseconomie=>War economy
Oorlogsmisdaden=>War crimes
Oorlogsschade=>War damage
Oorlogsslachtoffers=>War victims
Oorlogsspeelgoed=>War toys
Oorlogswinst=>War profit
Openbaar vervoer=>Public transport
Opera=>Opera
Oproeren=>Revolts
Opstanden=>Rebellions
Opticie¦êns=>Opticians
Opvoeding=>Upbringing
Ordeverstoringen=>Social disturbances
Organisatie=>Organization
Orgelbouwers=>Organ builders
Ouderdomsverzekeringen=>Old-age insurance
Ouderen=>Aged
Ouderenzorg=>Care for the aged
Ouderschapsverlof=>Parental leave
Overheid=>Government
Overheidsfinancie¦ên=>Public finance
Overheidspersoneel=>Civil servants
Pacht=>Tenancy
Pacifisme=>Pacifism
Palestijnen=>Palestinians
Palingoproer=>Palingoproer
Pamflet=>Leaflet
Papier=>Paper
Papiergeld=>Paper money
Papierindustrie=>Paper industry
Parfumeriee¦ên=>Perfumeries
Parfumeurs=>Perfumers
Parlement=>Parliament
Parlementsleden=>Members of parliament
Partijscholing=>Party training
Penning=>Medal
Pers=>Press
Personeelsbeleid=>Personnel management
Personeelswerving=>Recruitment of personnel
Persoonsregistratie=>Personel registration
Planeconomie=>Planned economy
Plantages=>Plantation
Plaquette=>Plaquette
Plattelandsbevolking=>Rural population
Ploegenarbeid=>Shift work
Poe¦êzie=>Poetry
Pokken=>Smallpox
Politie=>Police
Politiek=>Politics
Politieke emigratie=>Political emigration
Politieke gevangenen=>Political prisoners
Politieke partijen=>Political parties
Politieke prenten=>Political cartoons
Politieke schandalen=>Political scandals
Pompbedienden=>Pump attendants
Popmuziek=>Pop music
Pornografie=>Pornography
Portiers=>Doorkeepers
Portret=>Portrait
Pottenbakkers=>Potters
Prent=>Print
Prentbriefkaart=>Picture postcard
Presidentsverkiezingen=>Presidential elections
Prijslijst=>Price list
Prijzen=>Prices
Privacy=>Privacy
Privatisering=>Privatization
Processen=>Lawsuits
Productcatalogus=>Catalogue of products
Prostitutie=>Prostitution
Protestantisme=>Protestantism
Protestants christelijke vakbeweging=>Protestant trade union movement
Provinciale statenleden=>County councellors
Ptt=>PTT
Punkbeweging=>Punk movement
Raambiljet=>Window bill
Radenrepublieken=>Soviet Republics
Radio=>Radio
Rassendiscriminatie=>Racial discrimination
Rasterfoto=>Half-tone photo
Razzia's=>Razzia's
Re igie=>Religion
Recht=>Law
Rechts-extremisme=>Right extremism
Rechtshulp=>Legal aid
Rechtspraak=>Jurisdiction
Reclame=>Advertising
Reclamekaart=>Advertising card
Reclassering=>Prisoners rehabilitation
Recreatie=>Recreation
Recyclingsbedrijven=>Recycling companies
Reddingsbedrijven=>Life-boat services
Referenda=>Referenda
Regeringen=>Governments
Regeringsbeleid=>Government policy
Regionale besturen=>Regional governments
Regionale verkiezingen=>Regional elections
Religie=>Religion
Religieuze groepen=>Religious groups
Republicanisme=>Republicanism
Republieken=>Republics
Revolutie=>Revolution
Revolutie 1848=>Revolution 1848
Revolutie 1918=>Revolution 1918
Revoluties=>Revolutions
Rietsnijders=>Reed cutters
Rietsuiker=>Cane sugar
Rijwielindustrie=>Bicycle industry
Roken=>Smoking
Rolverdeling=>Role patterns
Rooms-katholicisme=>Roman Catholicism
Rooms-katholieke geestelijkheid=>Roman Catholic clergy
Rooms-katholieke kerk=>Roman Catholic church
Rooms-katholieke vakbeweging=>Roman Catholic trade union movement
Royalisme=>Royalism
Rubberindustrie=>Rubber industry
Ruilverkaveling=>Re-allotment
Ruimtevaart=>Space travel
Russische Revolutie 1905=>Russian Revolution 1905
Russische Revolutie 1917=>Russian Revolution 1917
Russische Revolutie februari 1917=>Russian Revolution Februari 1917
Russische Revolutie oktober 1917=>Russian Revolution October 1917
Samenlevingsvormen=>Type of cohabitation
Sandwichbord=>Sandwich-board
Scharenslijpers=>Knife-grinders
Scheepsbouw=>Shipbuilding
Scheepstimmerlieden=>Ship-builders
Scheepvaart=>Shipping
Schilderij=>Painting
Schildering=>Painting
Schilders=>Painters
Schoeisel=>Footwear
Schoenindustrie=>Shoemaking industry
Schoenmakers=>Shoemakers
Scholing=>Training
Schoonmaakbedrijven=>Cleaning services
Schoonmaakmiddelen=>Cleaning products
Schoonmakers=>Cleaners
Schrijfwaren=>Writing materials
Schrijvers=>Writers
Sculptuur=>Sculpture
Secularisme=>Secularism
Sekse=>Gender
Seksisme=>Sexism
Seksualiteit=>Sexuality
Seksueel geweld=>Sexual violence
Showkaart=>Showcard
Sieraden=>Jewellery
Sigarenmakers=>Cigarmakers
Sigaretten=>Cigarettes
Situationisme=>Situationism
Slagerijen=>Butcher's shops
Slagers=>Butchers
Slavernij=>Slavery
Slijterijen=>Liquor stores
Slopers=>Demolishers
Slopersbedrijven=>Demolition contractors
Sluitzegel=>Postery-stamp
Smeden=>Smiths
Smederijen=>Smithies
Smeermiddelen=>Lubricant
Smokkel=>Smuggling
Snoepgoed=>Sweets
Sociaal beleid=>Social policy
Sociaal-democratie=>Social democracy
Sociaal-economisch beleid=>Socio-economic policy
Sociale bewegingen=>Social movements
Sociale bijstand=>Supplementary benefit
Sociale groepen=>Social groups
Sociale kwestie=>Social inequality debate
Sociale ongelijkheid=>Social inequality
Sociale verzekeringen=>Social insurance
Sociale voorzieningen=>Social security
Sociale werkplaatsen=>Sheltered workshops
Sociale zorg=>Social services
Socialisatie=>Socialization
Socialisme=>Socialism
Socialistische bewegingen=>Socialist movements
Solidariteitsbewegingen=>Solidarity movements
Spaanse burgeroorlog=>Spanish Civil War
Spandoek=>Banner
Spanjaarden=>Spaniards
Speculatie=>Speculation
Speelgoed=>Toys
Speelgoedindustrie=>Toy industry
Spel=>Game
Speldje=>Badge
Spinners=>Spinners
Spiritualiteit=>Spirituality
Spoelsters=>Spindlers
Spoorwegen=>Railways
Spoorwegpersoneel=>Railway employees
Sport=>Sport
Sportartikelen=>Sports equipment
Sportartikelenindustrie=>Sports goods industry
Staalarbeiders=>Steelworkers
Staalindustrie=>Steel industry
Staat van beleg=>Martial law
Staatsgrepen=>Coups d'etat
Staatsinrichting=>Constitutional law
Staatsleningen=>Public loans
Staatsveiligheid=>State security
Staatsvorm=>Type of government
Stadsontwikkeling=>Urban development
Stadsreiniging=>City cleaning
Stadsvervoer=>Urban public transport
Stakingen=>Strikes
Stakingsrecht=>Right to strike
Stalknechten=>Grooms
Staten-Generaal=>Eerste Kamer
Statistieken=>Statistical data
Steenbakkerijen=>Brick making
Steenbakkers=>Brickmakers
Steenbewerkers=>Stonemasons
Sterke drank=>Liquor
Steunacties=>Collections
Sticker=>Sticker
Stickervel=>Sheet of stickers
Still=>Still
Stoelenmatters=>Chair-bottomers
Stopsters=>Darners
Straatbeelden=>Street scenes
Straatgevechten=>Street fights
Straathandelaars=>Street vendors
Straatmeubilair=>Street furniture
Straatvegers=>Road-sweepers
Strafrecht=>Criminal law
Stratenmakers=>Paviours
Streekvervoer=>Regional transport
Strijdmuziek=>Militant music
Strijksters=>Ironers
Stripverhalen=>Comic strips
Strohulzenmakers=>Straw cover makers
Studenten=>Students
Studentenbeweging=>Student movement
Studentenvoorzieningen=>Student facilities
Studiefinanciering=>Costs of studying
Subcultuur=>Subculture
Suiker=>Sugar
Suikerindustrie=>Sugar industry
Supermarkten=>Supermarkets
Surinamers=>Surinamers
Taalonderwijs=>Language education
Taalstrijd=>Language conflict
Tabak=>Tobacco
Tabakbewerkers=>Tobacco workers
Tabaksindustrie=>Tobacco industry
Tableaux vivants=>Tableaux vivants
Tamils=>Tamils
Taxibedrijven=>Taxi companies
Techniek=>Technical engineering
Technisch personeel=>Technical staff
Technisch tekenaars=>Technical draughtsmen
Technologie=>Technology
Tekening=>Drawing
Telefonisten=>Telephone operators
Televisie=>Television
Televisietoestellen=>Televisions
Tentenfabrieken=>Tent factories
Tentoonstellingen=>Exhibitions
Terrorisme=>Terrorism
Textiel=>Textile
Textielarbeiders=>Textile workers
Textielindustrie=>Textile industry
Theater=>Theatre
Thee=>Tea
Timmerlieden=>Carpenters
Toegangsbewijs=>Admission ticket
Toerisme=>Tourism
Toonkunstenaars=>Musicians
Touwslagerijen=>Ropeyards
Touwslagers=>Rope-makers
Tramwegen=>Tramways
Tramwegpersoneel=>Tramway staff
Transportarbeiders=>Transport workers
Transportmiddelenindustrie=>Transportation means industry
Trekarbeid=>Migrant work
Trotskisme=>Trotskyism
Trustvorming=>Trust formation
Tuberculose=>Tuberculosis
Tuinarbeiders=>Gardeners
Tuinartikelen=>Garden equipment
Tuinbouw=>Market-gardening
Tuinders=>Market gardeners
Turfstekers=>Peat-cutters
Turfwinning=>Peat-cutting
Turken=>Turks
Typisten=>Typists
Typografen=>Typographers
Uienschillers=>Onion peelers
Uitgeverijen=>Publishing houses
Universiteiten=>Universities
Utopiee¦ên=>Utopia
Vaandel=>Banner
Vaartuigen=>Vessels
Vakantiekampen=>Holiday camps
Vakbeweging=>Trade union movement
Vakbondsscholing=>Trade union training
Vandalisme=>Vandalism
Veehouders=>Cattle-breeders
Veembedrijven=>Warehouse companies
Veenarbeiders=>Peat diggers
Veerponten=>Ferries
Veeteelt=>Cattle-breeding
Vegetarisme=>Vegetarianism
Veilingen=>Auctions
Verbanning=>Exile
Verblijfsvergunning=>Staying permit
Verdedigingswerken=>Defence works
Verf=>Paint
Verhuizers=>Removers
Verkeer=>Traffic
Verkeersveiligheid=>Road safety
Verkiezingen=>Elections
Verlichting=>Lighting
Verpakking=>Packing material
Verpleegkundigen=>Nurses
Ververs=>Dyers
Vervoerbedrijven=>Transport companies
Verwarmingsapparaten=>Heating equipment
Verzekeringswezen=>Insurance business
Verzet=>Resistance
Verzuiling=>Verzuiling
Video=>Video
Video-apparatuur=>Video equipment
Vioolbouwers=>Violin builders
Vis=>Fish
Visitekaartje=>Visiting card
Visserij=>Fishing
Vissers=>Fishermen
Vivisectie=>Vivisection
Vlag=>Flag
Vlasserijen=>Flax industry
Vleesproducten=>Meat products
Vleeswarenindustrie=>Meat-packing industry
Vliegtuigbouw=>Aircraft construction
Vloeiblad=>Blotter
Vluchtelingen=>Refugees
Voeding=>Food
Voedingsindustrie=>Food industry
Voedingsmiddelen=>Food
Voedselgebrek=>Food shortage
Voedselvoorziening=>Food supply
Volkscultuur=>Popular culture
Volksmuziek=>Folk music
Volwasseneneducatie=>Popular education
Voorbehoedsmiddelen=>Preservatives
Voorwerp=>Object
Vorming=>Socio-cultural education
Vredesbeweging=>Peace movement
Vredesvoorwaarden=>Peace conditions
Vreemdelingenbeleid=>Immigration policy
Vrijheid van drukpers=>Freedom of the press
Vrijheid van meningsuiting=>Freedom of opinion
Vrijheid van organisatie=>Freedom of association
Vrijmetselarij=>Freemasonry
Vrijwilligersleger=>Voluntary armed forces
Vrijwilligerswerk=>Voluntary work
Vrouwen=>Women
Vrouwenarbeid=>Women's labour
Vrouwenbeweging=>Women's movement
Vrouwencultuur=>Women's culture
Vrouwenemancipatie=>Emancipation of women
Vrouwenkiesrecht=>Women's suffrage
Vuurtorenwachters=>Lighthouse-keepers
Waardepapier=>Securities
Wagenmakerijen=>Coach-building
Wapenhandel=>Arms trade
Wapenindustrie=>Arms industry
Wasmiddelen=>Detergents
Wasserijen=>Laundries
Waterbouw=>Hydraulic engineering
Waterverontreiniging=>Water pollution
Watervoorziening=>Water supply
Wederopbouw=>Reconstruction
Weduwen- en wezenpensioenen=>Widows' and orphans' pensions
Wegenbouw=>Road-building
Wegvervoer=>Road transport
Welzijnszorg=>Welfare work
Werkende jeugd=>Young workers
Werkgevers=>Employers
Werkgeversorganisaties=>Employers' organisations
Werkloosheid=>Unemployment
Werkloosheidsbestrijding=>Fight against unemployment
Werkloosheidsverzekeringen=>Unemployment insurance
Werknemers=>Employees
Werkverschaffing=>Employment projects
Westerse normen en waarden=>Western standards and values
Wetenschap=>Science and humanities
Wetgeving=>Legislation
Wevers=>Weavers
Wijn=>Wine
Wikkel=>Wrapper
Windenergie=>Wind energy
Winkelcentra=>Shopping centres
Winkelpersoneel=>Shop assistants
Winkelsluiting=>Shop closing
Winst=>Profit
Winstdeling=>Profit sharing
Wol=>Wool
Wolgaduitsers=>Wolga Germans
Woninginrichting=>Home furnishing
Woonschepen=>Living boats
Woonwagenbewoners=>Caravan-dwellers
Zadeldekmakers=>Saddlecloth makers
Zeelieden=>Seafarers
Zeevaart=>Sea transport
Zegel=>Stamp
Zeilmakers=>Sail-makers
Zelfbestuur=>Self-government
Ziekte=>Disease
Ziektekostenverzekeringen=>Medical insurance
Zigeuners=>Gypsies
Zionisme=>Zionism
Zomertijd=>Daylight-saving time
Zondagsrust=>Sunday rest
Zonnee¦ênergie=>Solar energy
Zoutjes=>Savoury snacks
Zuivelbewerkers=>Dairy workers
Zuivelindustrie=>Dairy industry
Zuivelproducten=>Dairy products
Zuiveringen=>Purges
Zure regen=>Acid rain
Zwarte handel=>Black market
Zwervers=>Vagabonds
